10 15
X X X X X X X X X X X X X X X
X Q . . . A . . . . . . . . X
X X X X X . X X X X X X X . X
X . . . . . X a . X X X X . X
X . X . X X X X B X X X S . X
X . X . . . X X . X X X X . X
X . X X X . . . . X . . . . X
X . X b X . X X X X . X X X X
X . . . X . . . . . . X X X X
X X X X X X X X X X X X X X X
