10 10
X X X X X X X X X X
X S . . . . . . b X
X X X X X . X X X X
X . B . . . X c . X
X . X . X X X X D X
X . X . . . X X . X
X . X X X . . A . X
X . X a X C X X X X
X . . d X . . Q . X
X X X X X X X X X X